Data;Descricao;Valor;Saldo
15/07/25 às 08:18:56;Pagamento para BANCO XP S/A;-R$ 1.527,06;R$ 1.154,16
14/07/25 às 09:49:45;Pix enviado para Servico Nacional de Aprendizagem Industrial Senai;-R$ 548,00;R$ 2.681,22
12/07/25 às 21:36:49;Pix recebido de Samuel Carvalho de Almeida;R$ 25,00;R$ 3.229,22
10/07/25 às 09:21:22;Pix enviado para Paulo Vitor Carvalho Vieira;-R$ 45,00;R$ 3.204,22
08/07/25 às 09:18:04;Pix enviado para Pedro Paulo Carvalho Vieira;-R$ 50,00;R$ 3.249,22
08/07/25 às 09:17:08;Transferência enviada para a conta investimento;-R$ 1.500,00;R$ 3.299,22
08/07/25 às 09:12:03;Pix recebido de Cred Facil Ltda;R$ 3.500,00;R$ 4.799,22